ABE1	CTGACCGAACGAT	PstI-MspI
ABE6	AACCTCATTCGAT	PstI-MspI
ABE11	CTGACATAATCGAT	PstI-MspI
AMA1	TCCTCGAATCGAT	PstI-MspI
AMA6	CCTGAGATACGAT	PstI-MspI
AMA11	TTCCACTTCGCGAT	PstI-MspI
ARB1	CAGAAGGAACGAT	PstI-MspI
ARB6	TTAGTCGGACGAT	PstI-MspI
ARB11	TAAGCCATTGTCGAT	PstI-MspI
CAR1	TTGGAGTGTCGAT	PstI-MspI
CAR7	TCGACCACTCGAT	PstI-MspI
CAR12	TTGGAGGCCAGCGAT	PstI-MspI
CHA1	CTGCAAGTTCGAT	PstI-MspI
CHA6	CAGATCCATCGAT	PstI-MspI
CHA11	AAGGAATCGTCGAT	PstI-MspI
COU1	AAGAGGATTCGAT	PstI-MspI
COU6	TCTATTCGTCGAT	PstI-MspI
COU11	TTCTCATTGAACGAT	PstI-MspI
COU16	TTCTAAGAGACGAT	PstI-MspI
DAP1	TCTAACGGACGAT	PstI-MspI
DAP6	AACCATCCGCGAT	PstI-MspI
DAP11	CTTGACACCGCGAT	PstI-MspI
DET1	TGAGCGGAACGAT	PstI-MspI
DET6	TGCCACGAACGAT	PstI-MspI
DET11	TAACAATCGGCGAT	PstI-MspI
DUH1	CGAGGTTATCGAT	PstI-MspI
DUH6	TGGAGCTTCCTCGAT	PstI-MspI
GEL1	TACCAAGATCGAT	PstI-MspI
GEL6	AGGCAATTGCGAT	PstI-MspI
GEL11	TCGCATCGTTCGAT	PstI-MspI
GEL17	TCCTAACATAACGAT	PstI-MspI
GRI1	TTCCGATAACGAT	PstI-MspI
GRI6	TTCGAGACGCGAT	PstI-MspI
GRI11	TGGAGGACGGACGAT	PstI-MspI
JON1	TTCGTGATTCGAT	PstI-MspI
JON6	TCGCAATTACGAT	PstI-MspI
JON11	CTTGAGAATGTCGAT	PstI-MspI
LED2	CTAAGGTAACGAT	PstI-MspI
LED7	TCTAGAGGTCGAT	PstI-MspI
LED12	TCCAAGCTGCGAT	PstI-MspI
LED17	TCAGTCCGAACGAT	PstI-MspI
LEM1	TAAGGAGAACGAT	PstI-MspI
LEM6	TCTGGATGACGAT	PstI-MspI
LEM11	TCTTACACACGAT	PstI-MspI
LEM16	TAAGGCAACCACGAT	PstI-MspI
MET1	TAGGTGGTTCGAT	PstI-MspI
MET6	TTACAACCTCGAT	PstI-MspI
MET11	AGCACGAATCGAT	PstI-MspI
